"0000000000000000000000000000000000000000000000000000000000000000000000000000000000000000000000000000000000000000000000000000000000000000000000000000"
"0                                                                                                                                                  0"
"0                                                                                                                                                  0"
"0                                                                                                                                                  0"
"0                                                                                                                                                  0"
"0                                                                                                                                                  0"
"0                                                                                                                                                  0"
"0                                                                                                                                                  0"
"0                                                                                                                                                  0"
"0                                                                                                                                                  0"
"0                                                                                                                                                  0"
"0                                                                                                                                                  0"
"0                                                                                                                                                  0"
"0                                                                                                                                                  0"
"0                                                                                                                                                  0"
"0                  60                                                                                                                              0"
"0                  00                  5               5                              5            5             5                                 0"
"3333333333333333333333333333333333333333333333333333333333333333333333333333333333333333333333333333333333333333333333333333333333333333333333333333"
"1111111111111111111111111111111111111111111111111111111111111111111111111111111111111111111111111111111111111111111111111111111111111111111111111111"
"0000000000000000000000000000000000000000000000000000000000000000000000000000000000000000000000000000000000000000000000000000000000000000000000000000"
